****************
*         *   E*
* ****  * ** ***
*    ****  *   *
**** *     *   *
*    *  ****** *
*S   *         *
****************